##############################
#............................#
#............................#
#......................##..###
#............................#
#.......#######.#............#
#....................#####.###
#............................#
#............................#
#....#########...............#
#...............@............#
#............................#
##############################