########################
#......................#
#......................#
#######..........#######
#......................#
#.........####.........#
#..........@...........#
#......................#
########################