#######################################
#.....................................#
#.....................................#
#..................*............#######
#.....................................#
#.......#########.....................#
#......................#####.###......#
#.....................................#
#.....................................#
#....#########........................#
#........................@............#
#.....................................#
#.....................................#
#######################################