##############################
#............................#
####.........................#
##......##.............##..###
#.......#....................#
#.......#######.#.#.#.######.#
#..........................###
#............................#
#............########........#
##############...............#
#...............@............#
#............................#
##############################