##############################
#.*.......###....#.*.#.......#
##.#......#*#.....#.#........#
##........#.#..........##..###
#........#...#...............#
#............................#
#.............*............###
#....#.#.....................#
#............#.####.#........#
#............................#
#...............@............#
#............................#
##############################